000000000000000000W00000000000000000
000000000000000000W00000000000000000
000000000000000000W00000000000000000
000000000000000000W00000000000000000
000000000000000000W00000000000000000
000000000000000000W00000000000000000
000000000000000000W00000000000000000
000000000000000000W00000000000000000
000000000000000000W00000000000000000
000000000000000000W00000000000000000
000000000000000000W00000000000000000
000000000000000000W00000000000000000
000000000000000000W00000000000000000
000000000000000000W00000000000000000
000000000000000000W00000000000000000
000000000000000000W00000000000000000
000000000000000000W00000000000000000
000000000000000000W00000000000000000
000000000000000000W00000000000000000
000000000000000000W00000000000000000
000000000000000000W00000000000000000
000000000000000000W00000000000000000
000000000000000000W00000000000000000
000000000000000000W00000000000000000
000000000000000000W00000000000000000
000000000000000000W00000000000000000
000000000000000000W00000000000000000
000000000000000000W00000000000000000
000000000000000000W00000000000000000
000000000000000000W00000000000000000
000000000000000000W00000000000000000
000000000000000000W00000000000000000
000000000000000000W00000000000000000
000000000000000000W00000000000000000
000000000000000000W00000000000000000
000000000000000000W00000000000000000
000000000000000000W00000000000000000
000000000000000000W00000000000000000
000000000000000000W00000000000000000
000000000000000000W00000000000000000
000000000000000000W00000000000000000
000000000000000000W00000000000000000
00000000P000000000W00000000000000000
000000000000000000W00000000000000000
000000000000000000W00000000000000000
000000000000000000W00000000000000000
000000000000000000W00000000000000000
000000000000000000W00000000000000000
111111111111111111111111111111111111
111111111111111111111111111111111111
111111111111111111111111111111111111
111111111111111111111111111111111111
111111111111111111111111111111111111
